0 0 0 0 0 4 0 4 0 4 0 4 0 4 0 0 0 0 0 0 0 0 4 0 0 0 0 0 4 210 
0 0 200 0 0 4 0 0 0 4 0 4 0 4 0 4 4 4 4 0 4 0 0 0 4 4 4 0 4 220 
0 0 0 0 0 4 4 4 0 4 0 4 0 4 0 0 0 0 4 0 4 4 4 4 4 0 0 0 4 0 
0 4 4 4 4 4 0 0 0 0 0 0 0 4 4 4 4 0 4 0 4 0 4 0 4 0 4 4 4 4
0 4 0 0 0 4 0 4 4 4 4 4 0 4 0 0 0 0 4 0 4 0 4 0 4 0 4 0 4 0
0 4 0 4 0 4 0 0 0 0 4 0 0 4 4 4 4 0 4 0 4 0 4 0 0 0 4 0 4 4 
0 0 0 4 0 4 0 4 4 4 4 0 4 4 4 0 0 0 4 0 4 0 4 0 4 0 0 0 0 0 
4 4 4 4 0 4 0 0 0 0 4 0 4 0 4 0 4 4 4 0 4 0 4 0 4 0 4 4 4 4 
0 4 0 0 0 4 4 0 4 0 4 0 0 0 4 0 4 0 4 0 4 0 4 0 4 0 0 0 0 4 
0 4 4 4 0 4 4 0 0 0 4 0 4 4 4 0 0 0 4 0 4 0 4 4 4 0 4 4 4 4 
0 0 0 0 0 4 4 0 4 0 4 0 0 0 4 4 4 0 4 0 4 0 4 0 4 0 4 0 0 0 
0 4 4 4 4 4 4 0 4 0 4 0 4 4 4 0 0 0 4 0 4 0 4 0 4 0 4 0 4 0 
0 4 0 0 0 4 0 0 4 0 4 0 0 0 0 0 4 0 4 0 4 0 4 0 4 0 0 0 4 0 
0 4 0 4 0 4 4 4 4 0 4 0 4 4 4 0 4 0 4 0 4 0 4 0 4 0 4 4 4 0  
0 0 0 4 0 4 0 0 0 0 4 0 4 0 0 0 0 0 4 0 0 0 4 0 0 0 0 0 0 0 
0 4 4 4 4 4 0 4 0 4 4 0 4 4 4 4 4 4 4 4 4 0 4 4 4 4 4 4 4 0 
0 0 0 0 0 4 0 4 4 4 4 0 0 4 100 0 0 0 4 0 4 0 4 0 0 0 4 0 0 0 
4 4 4 4 0 4 0 0 0 0 4 0 4 4 4 0 4 0 4 0 4 0 4 0 4 0 4 0 4 0 
0 4 0 4 0 4 4 4 4 0 4 0 0 0 4 0 4 0 4 0 4 0 4 0 4 0 4 0 4 0 
4 4 4 4 0 4 0 0 0 0 4 0 4 0 4 0 4 0 4 0 4 0 4 0 4 0 4 0 4 0 
0 0 4 0 0 4 0 4 0 0 4 0 0 0 4 0 4 0 4 0 4 0 4 0 4 0 4 0 4 0 
4 0 4 0 4 4 0 0 4 0 4 0 4 0 4 0 4 0 4 0 4 0 4 0 4 0 4 0 4 0 
0 0 0 0 0 4 4 0 0 4 4 0 0 0 0 0 4 0 4 0 4 0 4 0 4 0 4 0 4 0 
0 4 4 4 4 4 4 4 0 0 4 0 4 0 4 0 4 0 4 0 4 0 4 0 4 0 4 0 4 0 
0 4 0 0 0 4 4 0 0 0 4 0 0 0 4 0 4 0 4 0 4 0 4 0 4 0 4 0 4 0 
0 4 0 4 0 4 0 0 4 0 4 0 4 0 4 0 4 0 4 0 4 0 4 0 4 0 4 0 4 0 
0 0 0 4 0 4 0 4 0 0 4 0 0 0 4 0 4 0 4 0 4 0 4 0 4 0 4 0 4 0 
0 4 4 4 4 4 4 0 0 0 4 0 4 0 4 0 4 0 4 0 4 0 4 0 4 0 0 0 4 0 
0 0 0 4 0 0 0 0 0 4 4 0 0 0 4 0 0 0 4 0 4 0 4 0 4 4 4 4 4 4 
0 4 0 0 0 0 0 0 4 4 4 4 4 4 4 4 4 4 4 0 0 110 4 0 0 0 0 0 0 230 
