0 0 0 0 0 1 0 4 0 4 0 4 0 1 0 0 0 0 0 0 0 0 1 0 0 0 0 0 1 210 
0 0 200 0 0 1 0 0 0 4 0 4 0 1 0 4 4 4 1 0 1 0 0 0 1 1 1 0 1 220 
0 0 0 0 0 1 4 4 0 4 0 4 0 1 0 0 0 0 1 0 1 1 1 1 1 0 0 0 1 230 
0 4 4 4 4 1 0 0 0 0 0 0 0 1 4 4 4 0 1 0 1 0 1 0 1 0 1 1 1 100
0 4 0 0 0 1 0 4 4 4 4 4 0 1 0 0 0 0 1 0 1 0 1 0 1 0 1 0 1 110
0 4 0 4 0 1 0 0 0 0 4 0 0 1 4 4 4 0 1 0 1 0 1 0 0 0 1 0 1 1 
0 0 0 4 0 1 0 1 1 1 1 0 1 1 1 0 0 0 1 0 1 0 1 0 1 0 0 0 0 0 
4 4 4 4 0 1 0 0 0 0 1 0 1 0 1 0 4 4 1 0 1 0 1 0 1 0 1 1 1 1 
0 4 0 0 0 1 4 0 1 0 1 0 0 0 1 0 4 0 1 0 1 0 1 0 1 0 0 0 0 1 
0 4 4 4 0 1 4 0 0 0 1 0 1 1 1 0 0 0 1 0 1 0 1 1 1 0 1 1 1 1 
0 0 0 0 0 1 4 0 1 0 1 0 0 0 1 1 1 0 1 0 1 0 1 0 1 0 1 0 0 0 
0 4 4 4 4 1 4 0 1 0 1 0 1 1 1 0 0 0 1 0 1 0 1 0 1 0 1 0 1 0 
0 4 0 0 0 1 0 0 1 0 1 0 0 0 0 0 4 0 1 0 1 0 1 0 1 0 0 0 1 0 
0 4 0 4 0 1 1 1 1 0 1 0 1 1 1 0 4 0 1 0 1 0 1 0 1 0 1 1 1 0  
0 0 0 4 0 1 0 0 0 0 1 0 1 0 0 0 0 0 1 0 0 0 1 0 0 0 0 0 0 0 
0 4 4 4 4 1 0 1 0 4 1 0 1 1 1 1 1 1 1 1 1 0 1 4 4 4 4 4 4 0 
0 0 0 0 0 1 0 1 1 1 1 0 0 1 0 0 0 0 1 0 1 0 1 0 0 0 4 0 0 0 
4 4 4 4 0 1 0 0 0 0 1 0 1 1 1 0 4 0 1 0 1 0 1 0 4 0 4 0 4 0 
0 4 0 4 0 1 4 4 4 0 1 0 0 0 1 0 4 0 1 0 1 0 1 0 4 0 4 0 4 0 
4 4 4 4 0 1 0 0 0 0 1 0 1 0 1 0 4 0 1 0 1 0 1 0 4 0 4 0 4 0 
0 0 4 0 0 1 0 1 0 0 1 0 0 0 1 0 4 0 1 0 1 0 1 0 4 0 4 0 4 0 
4 0 4 0 4 1 0 0 1 0 1 0 1 0 1 0 4 0 1 0 1 0 1 0 4 0 4 0 4 0 
0 0 0 0 0 1 4 0 0 1 1 0 0 0 0 0 4 0 1 0 1 0 1 0 4 0 4 0 4 0 
0 4 4 4 4 1 4 4 0 0 1 0 1 0 1 0 4 0 1 0 1 0 1 0 4 0 4 0 4 0 
0 4 0 0 0 1 4 0 0 0 1 0 0 0 1 0 4 0 1 0 1 0 1 0 4 0 4 0 4 0 
0 4 0 4 0 1 0 0 1 0 1 0 1 0 1 0 4 0 1 0 1 0 1 0 4 0 4 0 4 0 
0 0 0 4 0 1 0 1 0 0 1 0 0 0 1 0 4 0 1 0 1 0 1 0 4 0 4 0 4 0 
0 4 4 4 4 1 1 0 0 0 1 0 1 0 1 0 4 0 1 0 1 0 1 0 4 0 0 0 4 0 
0 0 0 4 0 0 0 0 0 4 1 0 0 0 1 0 0 0 1 0 1 0 1 0 4 4 4 4 4 4 
0 4 0 0 0 0 0 0 4 4 1 1 1 1 1 1 1 1 1 0 0 0 1 0 0 0 0 0 0 0 
